14 18 21 0 5 1 1 1 1 1 1 1 1 6 0 0 0 0 0 0 
10 10 10 0 2 0 0 0 0 0 0 0 0 2 0 0 0 0 0 0 
13 17 19 0 2 0 0 0 0 0 9 0 0 2 0 0 0 0 0 0 
0 0 0 0 2 0 0 0 0 0 9 0 0 2 0 0 0 0 0 0 
0 0 0 0 2 0 0 0 0 0 0 0 0 2 0 0 0 0 0 0 
5 1 1 1 7 24 24 24 1 1 1 7 1 7 1 1 1 1 1 6 
2 0 0 0 0 0 0 0 0 0 0 2 0 0 0 0 0 0 0 2 
2 24 24 24 0 0 0 0 0 0 0 0 0 0 16 10 15 0 0 2 
2 24 24 24 0 0 0 7 0 0 0 0 0 0 11 10 12 0 0 2 
2 8 24 24 0 0 0 0 0 0 0 2 0 0 0 0 0 0 0 2 
4 1 1 1 1 1 1 1 1 1 1 7 1 1 1 1 1 1 1 3
448
192 

